NO ./texture/nord.xpm
SO ./texture/sud.xpm
WE ./texture/west.xpm
EA ./texture/east.xpm


F 20,100,0
C 200,25,0


        1111111111111111111111111
        1000000000110000000000001
        1011000001110000000000011
        10010000000000000N0000001
111111111011000001110000000000001
100000000011000001110111110111111
11110111111111011100000010001
11110111111111011101010010001

11000000110101011100000010001
10000000000000001101010010001
11000001110101011111011110001111
11110111 1110101 101111010001
11111111 1111111 111111111111
