NO ./texture/marble.xpm
SO ./texture/dalle.xpm
WE ./texture/hell.xpm
EA ./texture/brick.xpm


F 200,130,120
C 120,120,180

        1111111111111111111111111
        1000000000110000000000001
        1011000001110000000000001
        1001000000000000000N00001
111111111011000001110000000000001
10000000001100000111011111D111111
11110111111111011100000010001
11110111111111011101010010001
11000000110101011100000010001
10000000000000001100000010001
10000000000000001101010010001
11000001110K0101111101111000111
11110111 1110101 101111010001
11111111 1111111 111111111111



